........................................................................................................
......................................#######...........................................................
......................................#     #...........................................................
......................................#     #...........................................................
......................................#     #...........................................................
......................................#     #...........................................................
......................................#     #...........................................................
......................................#     #...........................................................
......................................#     #...........................................................
......................................#     #...........................................................
.##################...................#     #...................................................#######.
.#         #      #...................#######...................................................#     #.
.#         #      #.............................................................................#     #.
.#         #      #.............................................................................#     #.
.#         #      #.............................................................................#     #.
.#         #      #.............................................................................#     #.
.#         #      #.............................................................................#     #.
.#         #      #........................#######..............###########.....................#     #.
.##################........................#     #..............#         #.....................#######.
...........................................#     #..............#         #.............................
...........................................#     #..............#         #.............................
...........................................#     #..............#         #.............................
...........................................#     #..............#         #.............................
...........................................#     #..............#         #.............................
...............................#########...#     ################         #..............#########......
...............................#       #...#######      #       ###########..............#       #......
...............................#       #...#    #       #        #.......................#       #......
...............................#       #...#    #       #        #.......................#       #......
...............................#       #...#    #       #        #.......................#       #......
...............................#       #...#    #       #        #.......................#       #......
...............................#       #...#    #       #        #.......................#       #......
...............................#       #...#    #       #        #.......#########.......#       #......
...............................#########...#######################.......#       #.......#########......
.........................................................................#       #......................
.........................................................................#       #......................
.........................................................................#       #......................
.........................................................................#       #......................
.........................................................................#       #......................
..........#########......................................................#      ##################......
..........#       #......................................................########        #       #......
..........#       #.............................................................#        #       #......
..........#       #.............................................................#        #       #......
..........#       #.............................................................#        #       #......
..........#       #.............................................................#        #       ######.
..........#########.............................................................##################    #.
................................................................................................#     #.
................................................................................................#     #.
................................................................................................#     #.
...............................#########........................................................#     #.
...............................#       #........................................................#######.
...............................#       #................................................................
...............................#       #................................................................
...............................#       #................................................................
...............................#       #................................................................
...............................#       #................................................................
...............................#       #...#######..............................###########.............
...............................#########...#     #..............................#         #.............
...........................................#     #..............................#         #.............
...........................................#     #..............................#         #.............
...........................................#     #..............................#         #.............
...........................................#  E  #..............................#         #.............
...........................................#     #..............................#         #.............
...........................................#     #..............................#         #.............
...........................................#     #..............................#         #.............
...............................#########...#     #..............................#         #.............
...............................#       #...#######..............................###########.............
...............................#       #................................................................
...............................#       #................................................................
...............................#       #................................................................
...............................#       #................................................................
...............................#       #................................................................
...............................#       #................................................................
...............................#       #................................................................
...............................#       ######...........................................................
...............................#########    #...........................................................
......................................#     #...........................................................
......................................#     #...........................................................
......................................#     #...........................................................
......................................#     #...........................................................
......................................#     #...........................................................
......................................#     #...................................###########.....#######.
......................................#######...................................#         #.....#     #.
................................................................................#         #.....#     #.
................................................................................#         #.....#     #.
................................................................................#         #.....#     #.
................................................................................#         #.....#     #.
................................................................................#         #.....#     #.
................................................................................#         #.....#     #.
................................................................................#         #.....#     #.
................................................................................#         #.....#     #.
................................................................................###########.....#######.
........................................................................................................
........................................................................................................
........................................................................................................
........................................................................................................
........................................................................................................
.................#########..............................................................................
.................#       #..............................................................................
.................#       #..............................................................................
.................#   S   #..............................................................................
.................#       #..............................................................................
.................#       #..............................................................................
.................#########..............................................................................
........................................................................................................
