........................................................................
.######################################################################.
.#          #           #        #           #         #              #.
.#          #           #        #           #         #              #.
.#          #           #        #           #         #              #.
.#          #           #        #           #         #              #.
.#          #           #        #           #         #      E       #.
.#          #           #        #           #         #              #.
.#          #           #        #           #         #              #.
.#############          ##########           #         #              #.
.#           ############        ######################################.
.#           #..........#        #...........#         #................
.#           #..........#        #...........#         #................
.#           #..........#    S   #...........#         #................
.#           #..........#        #...........#         #................
.#           #..........#        #############         #................
.#############..........##########           ###########................
................................#            #         #................
................................#            #         #................
................................#            #         #................
................................#            #         #................
.#########################......########################................
.#           #           #......#             #        #................
.#           #           #......#             #        #................
.#           #           #......#             #        #................
.#           #           #......#             #        #................
.#           #           #......#             #        #................
.#           #           #......#             #        #................
.#           #          ##########           ###########................
.########################        #############         #................
........................#        #...........#         #................
........................#        #...........#         #................
........................#        #...........#         #................
........................#        #...........#         #................
........................#        #...........###########................
........................##########...........#         #................
........................#        #...........#         #................
........................#        #...........#         #................
........................##########...........###########................
........................................................................
