........................................................................................................
..........################......############..............................########......#######.........
..........#        #     #......#          #..............................#      #......#     #.........
..........#        #     #......#          #..............................#      #......#     #.........
..........#        #     #......#          #..............................#      #......#     #.........
..........#        #     #......#          #..............................#      #......#     #.........
..........#        #     #......#          #..............................#      #......#     #.........
..........#        #     #......#          #..............................#      #......#     #.........
..........#        #     #......#          #..............................#      #......#     #.........
..........#        #     #......#          #..............................#      #......#     #.........
..........#        #     #......#          #..............................#      #......#     #.........
..........################......############..............................########......#######.........
........................................................................................................
........................................................................................................
........................................................................................................
........................................................................................................
........................................................................................................
........................................................................................................
........................................................................................................
........................................................................................................
........................................................................................................
........................................................................................................
........................................................................................................
........................................................................................................
...................#######..............................................................................
...................#     #..............................................................................
...................#     #..............................................................................
...................#     #..............................................................................
...................#     #..............................................................................
...................#     #..............................................................................
...................#     #..............................................................................
...................#     #..............................................................................
...................#    ##########......................................................................
...................######        #......................................................................
........................#        #......................................................................
........................#        #......................................................................
........................#        #......................................................................
........................#        #......................................................................
........................#        #......................................................................
........................#        #......................................................................
........................#        #......................................................................
........................#        #......................................................................
........................#        #....................##########........................................
........................##########....................#        #........................................
......................................................#        #........................................
......................................................#        #........................................
......................................................#        #........................................
......................................................#        #........................................
..........################............................#        #........................................
..........#         #    #............................##########........................................
..........#         #    #..............................................................................
..........#         #    #..............................................................................
..........#         #    #..............................................................................
..........#         #    #..............................................................................
..........#        #######................########......................................................
..........##########     #................#      #......................................................
...................#     #................#      #......................................................
...................#     #................#      #......................................................
...................#     #................#      #......................................................
...................#     #................#      #......................................................
...................#     #................#      #......................................................
...................#     #................#      #......................................................
...................#     #................#      #######.............#######............................
...................#######................########     #.............#     #............................
................................................#      #.............#     #............................
................................................#      #.............#     #............................
................................................#      #.............#     #............................
................................................#      #.............#     #............................
................................................#      #.............#     #............................
..........###########.....................########     #.............#     #............#######.........
..........#         #.....................#      #######.............#######............#     #.........
..........#         #.....................#      #......................................#     #.........
..........#         #.....................#      #......................................#     #.........
..........#         #.....................#      #......................................#     #.........
..........#         #.....................#      #...................#######............#     #.........
..........###########.....................########...................#     #............#######.........
.....................................................................#     #............................
.....................................................................#     #............................
.....................................................................#     #............................
.....................................................................#     #............................
..........###########.........................................#########    #.................##########.
..........#         #.........................................#       ######.................#        #.
..........#         #.........................................#       #......................#        #.
..........#         #.........................................#       #......................#        #.
..........#         #.........................................#       #......................#        #.
..........#         #.........................................#       #......................#        #.
..........#         #.........................................#       #......................#        #.
..........#         #.........................................#       #......................#        #.
..........#         #...........................########......#       ######............######        #.
..........###########...........................#      #......#########    #............#    ##########.
................................................#      #.............#     #............#     #.........
................................................#      #.............#     #............#     #.........
................................................#      #.............#     #............#     #.........
........................##########..............#      #.............#     #............#     #.........
........................#        #..............########.............#######............#######.........
........................#        #......................................................................
........................#        #......................................................................
........................#        #......................................................................
........................#        #......................................................................
........................#        #......................................................................
........................#        #......................................................................
........................#        #......................................................................
........................##########......................................................................
........................................................................................................
